13 21 5 4
00000000000A000000000
0B0000000000000000H00
000000010000000000000
00000000000000D00G000
000000000000000000000
000A00000000000F00000
000000000000000000000
000200000000000000000
0000000C0000000000000
000000000E00000000000
00000G000000000000000
000000000000G00000000
00000000000000000I000
C
D
B
H
A
5
C 2
D 3
B 2
H 1
A 1
2
H 2
I 3