13 20 3 5
00000000000A00000000
0B000000000000000000
000ABCDEFGHIJ0000000
00000000000000000G00
00000000000000000000
0D000000E00000000000
00000000000000000000
00000000A00000000200
00F0000C000000000000
00000000000000000000
00000G00000000000000
001000000000G0000000
H0000000000000000I00
C
B
A
2
A 2
B 3
2
A 2
E 3